he ain't cracking	he isn't cracking
she ain't cracking	she isn't cracking
they ain't cracking	they aren't cracking
he ain't loving	he isn't loving
she ain't loving	she isn't loving
they ain't loving	they aren't loving
he ain't acting	he isn't acting
she ain't acting	she isn't acting
they ain't acting	they aren't acting
he ain't blowing	he isn't blowing
she ain't blowing	she isn't blowing
they ain't blowing	they aren't blowing
he ain't f’ing	he isn't f’ing
she ain't f’ing	she isn't f’ing
they ain't f’ing	they aren't f’ing
he ain't playing	he isn't playing
she ain't playing	she isn't playing
they ain't playing	they aren't playing
he ain't balling	he isn't balling
she ain't balling	she isn't balling
they ain't balling	they aren't balling
he ain't linking	he isn't linking
she ain't linking	she isn't linking
they ain't linking	they aren't linking
he ain't hating	he isn't hating
she ain't hating	she isn't hating
they ain't hating	they aren't hating
he ain't busting	he isn't busting
she ain't busting	she isn't busting
they ain't busting	they aren't busting
he ain't bugging	he isn't bugging
she ain't bugging	she isn't bugging
they ain't bugging	they aren't bugging
he ain't fooling	he isn't fooling
she ain't fooling	she isn't fooling
they ain't fooling	they aren't fooling
he ain't vibing	he isn't vibing
she ain't vibing	she isn't vibing
they ain't vibing	they aren't vibing
he ain't rapping	he isn't rapping
she ain't rapping	she isn't rapping
they ain't rapping	they aren't rapping
he ain't blasting	he isn't blasting
she ain't blasting	she isn't blasting
they ain't blasting	they aren't blasting
he ain't slaying	he isn't slaying
she ain't slaying	she isn't slaying
they ain't slaying	they aren't slaying
he ain't whipping	he isn't whipping
she ain't whipping	she isn't whipping
they ain't whipping	they aren't whipping
he ain't finding	he isn't finding
she ain't finding	she isn't finding
they ain't finding	they aren't finding
he ain't parking	he isn't parking
she ain't parking	she isn't parking
they ain't parking	they aren't parking
he ain't creeping	he isn't creeping
she ain't creeping	she isn't creeping
they ain't creeping	they aren't creeping
he ain't fricking	he isn't fricking
she ain't fricking	she isn't fricking
they ain't fricking	they aren't fricking
he ain't dripping	he isn't dripping
she ain't dripping	she isn't dripping
they ain't dripping	they aren't dripping
he ain't stitching	he isn't stitching
she ain't stitching	she isn't stitching
they ain't stitching	they aren't stitching
he ain't killing	he isn't killing
she ain't killing	she isn't killing
they ain't killing	they aren't killing
he ain't believing	he isn't believing
she ain't believing	she isn't believing
they ain't believing	they aren't believing
he ain't cutting	he isn't cutting
she ain't cutting	she isn't cutting
they ain't cutting	they aren't cutting
he ain't getting	he isn't getting
she ain't getting	she isn't getting
they ain't getting	they aren't getting
he ain't riding	he isn't riding
she ain't riding	she isn't riding
they ain't riding	they aren't riding
he ain't walking	he isn't walking
she ain't walking	she isn't walking
they ain't walking	they aren't walking
he ain't bitching	he isn't bitching
she ain't bitching	she isn't bitching
they ain't bitching	they aren't bitching
he ain't everything	he isn't everything
she ain't everything	she isn't everything
they ain't everything	they aren't everything
he ain't kicking	he isn't kicking
she ain't kicking	she isn't kicking
they ain't kicking	they aren't kicking
he ain't kidding	he isn't kidding
she ain't kidding	she isn't kidding
they ain't kidding	they aren't kidding
he ain't banging	he isn't banging
she ain't banging	she isn't banging
they ain't banging	they aren't banging
he ain't breaking	he isn't breaking
she ain't breaking	she isn't breaking
they ain't breaking	they aren't breaking
he ain't chatting	he isn't chatting
she ain't chatting	she isn't chatting
they ain't chatting	they aren't chatting
he ain't amazing	he isn't amazing
she ain't amazing	she isn't amazing
they ain't amazing	they aren't amazing
he ain't hecking	he isn't hecking
she ain't hecking	she isn't hecking
they ain't hecking	they aren't hecking
he ain't starting	he isn't starting
she ain't starting	she isn't starting
they ain't starting	they aren't starting
he ain't cheesing	he isn't cheesing
she ain't cheesing	she isn't cheesing
they ain't cheesing	they aren't cheesing
he ain't dreaming	he isn't dreaming
she ain't dreaming	she isn't dreaming
they ain't dreaming	they aren't dreaming
he ain't fronting	he isn't fronting
she ain't fronting	she isn't fronting
they ain't fronting	they aren't fronting
he ain't drinking	he isn't drinking
she ain't drinking	she isn't drinking
they ain't drinking	they aren't drinking
he ain't darling	he isn't darling
she ain't darling	she isn't darling
they ain't darling	they aren't darling
he ain't pulling	he isn't pulling
she ain't pulling	she isn't pulling
they ain't pulling	they aren't pulling
he ain't talking	he isn't talking
she ain't talking	she isn't talking
they ain't talking	they aren't talking
he ain't hanging	he isn't hanging
she ain't hanging	she isn't hanging
they ain't hanging	they aren't hanging
he ain't cooking	he isn't cooking
she ain't cooking	she isn't cooking
they ain't cooking	they aren't cooking
he ain't staying	he isn't staying
she ain't staying	she isn't staying
they ain't staying	they aren't staying
he ain't using	he isn't using
she ain't using	she isn't using
they ain't using	they aren't using
he ain't packing	he isn't packing
she ain't packing	she isn't packing
they ain't packing	they aren't packing
he ain't pissing	he isn't pissing
she ain't pissing	she isn't pissing
they ain't pissing	they aren't pissing
he ain't capping	he isn't capping
she ain't capping	she isn't capping
they ain't capping	they aren't capping
he ain't throwing	he isn't throwing
she ain't throwing	she isn't throwing
they ain't throwing	they aren't throwing
he ain't singing	he isn't singing
she ain't singing	she isn't singing
they ain't singing	they aren't singing
he ain't bleeding	he isn't bleeding
she ain't bleeding	she isn't bleeding
they ain't bleeding	they aren't bleeding
he ain't spinning	he isn't spinning
she ain't spinning	she isn't spinning
they ain't spinning	they aren't spinning
he ain't calling	he isn't calling
she ain't calling	she isn't calling
they ain't calling	they aren't calling
he ain't dancing	he isn't dancing
she ain't dancing	she isn't dancing
they ain't dancing	they aren't dancing
he ain't dropping	he isn't dropping
she ain't dropping	she isn't dropping
they ain't dropping	they aren't dropping
he ain't rambling	he isn't rambling
she ain't rambling	she isn't rambling
they ain't rambling	they aren't rambling
he ain't willing	he isn't willing
she ain't willing	she isn't willing
they ain't willing	they aren't willing
he ain't shitting	he isn't shitting
she ain't shitting	she isn't shitting
they ain't shitting	they aren't shitting
he ain't flipping	he isn't flipping
she ain't flipping	she isn't flipping
they ain't flipping	they aren't flipping
he ain't dying	he isn't dying
she ain't dying	she isn't dying
they ain't dying	they aren't dying
he ain't watching	he isn't watching
she ain't watching	she isn't watching
they ain't watching	they aren't watching
he ain't feeling	he isn't feeling
she ain't feeling	she isn't feeling
they ain't feeling	they aren't feeling
he ain't missing	he isn't missing
she ain't missing	she isn't missing
they ain't missing	they aren't missing
he ain't waving	he isn't waving
she ain't waving	she isn't waving
they ain't waving	they aren't waving
he ain't cussing	he isn't cussing
she ain't cussing	she isn't cussing
they ain't cussing	they aren't cussing
he ain't bobbing	he isn't bobbing
she ain't bobbing	she isn't bobbing
they ain't bobbing	they aren't bobbing
he ain't flexing	he isn't flexing
she ain't flexing	she isn't flexing
they ain't flexing	they aren't flexing
he ain't begging	he isn't begging
she ain't begging	she isn't begging
they ain't begging	they aren't begging
he ain't paying	he isn't paying
she ain't paying	she isn't paying
they ain't paying	they aren't paying
he ain't standing	he isn't standing
she ain't standing	she isn't standing
they ain't standing	they aren't standing
he ain't coming	he isn't coming
she ain't coming	she isn't coming
they ain't coming	they aren't coming
he ain't frigging	he isn't frigging
she ain't frigging	she isn't frigging
they ain't frigging	they aren't frigging
he ain't stepping	he isn't stepping
she ain't stepping	she isn't stepping
they ain't stepping	they aren't stepping
he ain't picking	he isn't picking
she ain't picking	she isn't picking
they ain't picking	they aren't picking
he ain't puffing	he isn't puffing
she ain't puffing	she isn't puffing
they ain't puffing	they aren't puffing
he ain't asking	he isn't asking
she ain't asking	she isn't asking
they ain't asking	they aren't asking
he ain't morning	he isn't morning
she ain't morning	she isn't morning
they ain't morning	they aren't morning
he ain't eating	he isn't eating
she ain't eating	she isn't eating
they ain't eating	they aren't eating
he ain't icing	he isn't icing
she ain't icing	she isn't icing
they ain't icing	they aren't icing
he ain't breathing	he isn't breathing
she ain't breathing	she isn't breathing
they ain't breathing	they aren't breathing
he ain't digging	he isn't digging
she ain't digging	she isn't digging
they ain't digging	they aren't digging
he ain't laughing	he isn't laughing
she ain't laughing	she isn't laughing
they ain't laughing	they aren't laughing
he ain't shining	he isn't shining
she ain't shining	she isn't shining
they ain't shining	they aren't shining
he ain't pimping	he isn't pimping
she ain't pimping	she isn't pimping
they ain't pimping	they aren't pimping
he ain't catching	he isn't catching
she ain't catching	she isn't catching
they ain't catching	they aren't catching
he ain't saying	he isn't saying
she ain't saying	she isn't saying
they ain't saying	they aren't saying
he ain't jumping	he isn't jumping
she ain't jumping	she isn't jumping
they ain't jumping	they aren't jumping
he ain't faking	he isn't faking
she ain't faking	she isn't faking
they ain't faking	they aren't faking
he ain't knocking	he isn't knocking
she ain't knocking	she isn't knocking
they ain't knocking	they aren't knocking
he ain't rocking	he isn't rocking
she ain't rocking	she isn't rocking
they ain't rocking	they aren't rocking
he ain't summing	he isn't summing
she ain't summing	she isn't summing
they ain't summing	they aren't summing
he ain't selling	he isn't selling
she ain't selling	she isn't selling
they ain't selling	they aren't selling
he ain't effing	he isn't effing
she ain't effing	she isn't effing
they ain't effing	they aren't effing
he ain't ghosting	he isn't ghosting
she ain't ghosting	she isn't ghosting
they ain't ghosting	they aren't ghosting
he ain't leaving	he isn't leaving
she ain't leaving	she isn't leaving
they ain't leaving	they aren't leaving
he ain't smoking	he isn't smoking
she ain't smoking	she isn't smoking
they ain't smoking	they aren't smoking
he ain't waiting	he isn't waiting
she ain't waiting	she isn't waiting
they ain't waiting	they aren't waiting
he ain't slipping	he isn't slipping
she ain't slipping	she isn't slipping
they ain't slipping	they aren't slipping
he ain't flaming	he isn't flaming
she ain't flaming	she isn't flaming
they ain't flaming	they aren't flaming
he ain't blazing	he isn't blazing
she ain't blazing	she isn't blazing
they ain't blazing	they aren't blazing
he ain't bringing	he isn't bringing
she ain't bringing	she isn't bringing
they ain't bringing	they aren't bringing
he ain't checking	he isn't checking
she ain't checking	she isn't checking
they ain't checking	they aren't checking
he ain't bigging	he isn't bigging
she ain't bigging	she isn't bigging
they ain't bigging	they aren't bigging
he ain't sitting	he isn't sitting
she ain't sitting	she isn't sitting
they ain't sitting	they aren't sitting
he ain't burning	he isn't burning
she ain't burning	she isn't burning
they ain't burning	they aren't burning
he ain't greeting	he isn't greeting
she ain't greeting	she isn't greeting
they ain't greeting	they aren't greeting
he ain't falling	he isn't falling
she ain't falling	she isn't falling
they ain't falling	they aren't falling
he ain't nothing	he isn't nothing
she ain't nothing	she isn't nothing
they ain't nothing	they aren't nothing
he ain't praying	he isn't praying
she ain't praying	she isn't praying
they ain't praying	they aren't praying
he ain't messing	he isn't messing
she ain't messing	she isn't messing
they ain't messing	they aren't messing
he ain't moving	he isn't moving
she ain't moving	she isn't moving
they ain't moving	they aren't moving
he ain't looking	he isn't looking
she ain't looking	she isn't looking
they ain't looking	they aren't looking
he ain't telling	he isn't telling
she ain't telling	she isn't telling
they ain't telling	they aren't telling
he ain't tweaking	he isn't tweaking
she ain't tweaking	she isn't tweaking
they ain't tweaking	they aren't tweaking
he ain't giving	he isn't giving
she ain't giving	she isn't giving
they ain't giving	they aren't giving
he ain't keeping	he isn't keeping
she ain't keeping	she isn't keeping
they ain't keeping	they aren't keeping
he ain't cruising	he isn't cruising
she ain't cruising	she isn't cruising
they ain't cruising	they aren't cruising
he ain't sending	he isn't sending
she ain't sending	she isn't sending
they ain't sending	they aren't sending
he ain't swinging	he isn't swinging
she ain't swinging	she isn't swinging
they ain't swinging	they aren't swinging
he ain't listening	he isn't listening
she ain't listening	she isn't listening
they ain't listening	they aren't listening
he ain't living	he isn't living
she ain't living	she isn't living
they ain't living	they aren't living
he ain't lying	he isn't lying
she ain't lying	she isn't lying
they ain't lying	they aren't lying
he ain't working	he isn't working
she ain't working	she isn't working
they ain't working	they aren't working
he ain't woofing	he isn't woofing
she ain't woofing	she isn't woofing
they ain't woofing	they aren't woofing
he ain't having	he isn't having
she ain't having	she isn't having
they ain't having	they aren't having
he ain't popping	he isn't popping
she ain't popping	she isn't popping
they ain't popping	they aren't popping
he ain't chasing	he isn't chasing
she ain't chasing	she isn't chasing
they ain't chasing	they aren't chasing
he ain't fcuking	he isn't fcuking
she ain't fcuking	she isn't fcuking
they ain't fcuking	they aren't fcuking
he ain't flying	he isn't flying
she ain't flying	she isn't flying
they ain't flying	they aren't flying
he ain't blooming	he isn't blooming
she ain't blooming	she isn't blooming
they ain't blooming	they aren't blooming
he ain't bopping	he isn't bopping
she ain't bopping	she isn't bopping
they ain't bopping	they aren't bopping
he ain't rolling	he isn't rolling
she ain't rolling	she isn't rolling
they ain't rolling	they aren't rolling
he ain't turning	he isn't turning
she ain't turning	she isn't turning
they ain't turning	they aren't turning
he ain't howling	he isn't howling
she ain't howling	she isn't howling
they ain't howling	they aren't howling
he ain't doing	he isn't doing
she ain't doing	she isn't doing
they ain't doing	they aren't doing
he ain't ranking	he isn't ranking
she ain't ranking	she isn't ranking
they ain't ranking	they aren't ranking
he ain't happening	he isn't happening
she ain't happening	she isn't happening
they ain't happening	they aren't happening
he ain't grating	he isn't grating
she ain't grating	she isn't grating
they ain't grating	they aren't grating
he ain't stressing	he isn't stressing
she ain't stressing	she isn't stressing
they ain't stressing	they aren't stressing
he ain't lurking	he isn't lurking
she ain't lurking	she isn't lurking
they ain't lurking	they aren't lurking
he ain't seeing	he isn't seeing
she ain't seeing	she isn't seeing
they ain't seeing	they aren't seeing
he ain't hitting	he isn't hitting
she ain't hitting	she isn't hitting
they ain't hitting	they aren't hitting
he ain't evening	he isn't evening
she ain't evening	she isn't evening
they ain't evening	they aren't evening
he ain't driving	he isn't driving
she ain't driving	she isn't driving
they ain't driving	they aren't driving
he ain't surfing	he isn't surfing
she ain't surfing	she isn't surfing
they ain't surfing	they aren't surfing
he ain't freaking	he isn't freaking
she ain't freaking	she isn't freaking
they ain't freaking	they aren't freaking
he ain't showing	he isn't showing
she ain't showing	she isn't showing
they ain't showing	they aren't showing
he ain't hitching	he isn't hitching
she ain't hitching	she isn't hitching
they ain't hitching	they aren't hitching
he ain't wearing	he isn't wearing
she ain't wearing	she isn't wearing
they ain't wearing	they aren't wearing
he ain't tripping	he isn't tripping
she ain't tripping	she isn't tripping
they ain't tripping	they aren't tripping
he ain't styling	he isn't styling
she ain't styling	she isn't styling
they ain't styling	they aren't styling
he ain't being	he isn't being
she ain't being	she isn't being
they ain't being	they aren't being
he ain't blinking	he isn't blinking
she ain't blinking	she isn't blinking
they ain't blinking	they aren't blinking
he ain't running	he isn't running
she ain't running	she isn't running
they ain't running	they aren't running
he ain't chilling	he isn't chilling
she ain't chilling	she isn't chilling
they ain't chilling	they aren't chilling
he ain't grooving	he isn't grooving
she ain't grooving	she isn't grooving
they ain't grooving	they aren't grooving
he ain't sleeping	he isn't sleeping
she ain't sleeping	she isn't sleeping
they ain't sleeping	they aren't sleeping
he ain't annoying	he isn't annoying
she ain't annoying	she isn't annoying
they ain't annoying	they aren't annoying
he ain't stinking	he isn't stinking
she ain't stinking	she isn't stinking
they ain't stinking	they aren't stinking
he ain't dunking	he isn't dunking
she ain't dunking	she isn't dunking
they ain't dunking	they aren't dunking
he ain't raging	he isn't raging
she ain't raging	she isn't raging
they ain't raging	they aren't raging
he ain't heading	he isn't heading
she ain't heading	she isn't heading
they ain't heading	they aren't heading
he ain't booming	he isn't booming
she ain't booming	she isn't booming
they ain't booming	they aren't booming
he ain't putting	he isn't putting
she ain't putting	she isn't putting
they ain't putting	they aren't putting
he ain't tweeting	he isn't tweeting
she ain't tweeting	she isn't tweeting
they ain't tweeting	they aren't tweeting
he ain't buzzing	he isn't buzzing
she ain't buzzing	she isn't buzzing
they ain't buzzing	they aren't buzzing
he ain't repping	he isn't repping
she ain't repping	she isn't repping
they ain't repping	they aren't repping
he ain't thinking	he isn't thinking
she ain't thinking	she isn't thinking
they ain't thinking	they aren't thinking
he ain't holding	he isn't holding
she ain't holding	she isn't holding
they ain't holding	they aren't holding
he ain't crying	he isn't crying
she ain't crying	she isn't crying
they ain't crying	they aren't crying
he ain't trying	he isn't trying
she ain't trying	she isn't trying
they ain't trying	they aren't trying
he ain't making	he isn't making
she ain't making	she isn't making
they ain't making	they aren't making
he ain't screaming	he isn't screaming
she ain't screaming	she isn't screaming
they ain't screaming	they aren't screaming
he ain't sipping	he isn't sipping
she ain't sipping	she isn't sipping
they ain't sipping	they aren't sipping
he ain't cumming	he isn't cumming
she ain't cumming	she isn't cumming
they ain't cumming	they aren't cumming
he ain't jamming	he isn't jamming
she ain't jamming	she isn't jamming
they ain't jamming	they aren't jamming
he ain't hustling	he isn't hustling
she ain't hustling	she isn't hustling
they ain't hustling	they aren't hustling
he ain't raising	he isn't raising
she ain't raising	she isn't raising
they ain't raising	they aren't raising
he ain't shaking	he isn't shaking
she ain't shaking	she isn't shaking
they ain't shaking	they aren't shaking
he ain't something	he isn't something
she ain't something	she isn't something
they ain't something	they aren't something
he ain't licking	he isn't licking
she ain't licking	she isn't licking
they ain't licking	they aren't licking
he ain't smiling	he isn't smiling
she ain't smiling	she isn't smiling
they ain't smiling	they aren't smiling
he ain't tapping	he isn't tapping
she ain't tapping	she isn't tapping
they ain't tapping	they aren't tapping
he ain't taking	he isn't taking
she ain't taking	she isn't taking
they ain't taking	they aren't taking
he ain't going	he isn't going
she ain't going	she isn't going
they ain't going	they aren't going
he ain't fighting	he isn't fighting
she ain't fighting	she isn't fighting
they ain't fighting	they aren't fighting
he ain't stomping	he isn't stomping
she ain't stomping	she isn't stomping
they ain't stomping	they aren't stomping
he ain't wanting	he isn't wanting
she ain't wanting	she isn't wanting
they ain't wanting	they aren't wanting
he ain't growing	he isn't growing
she ain't growing	she isn't growing
they ain't growing	they aren't growing
he ain't trapping	he isn't trapping
she ain't trapping	she isn't trapping
they ain't trapping	they aren't trapping
he ain't grinding	he isn't grinding
she ain't grinding	she isn't grinding
they ain't grinding	they aren't grinding
he ain't winning	he isn't winning
she ain't winning	she isn't winning
they ain't winning	they aren't winning
he ain't rooting	he isn't rooting
she ain't rooting	she isn't rooting
they ain't rooting	they aren't rooting
he ain't sweating	he isn't sweating
she ain't sweating	she isn't sweating
they ain't sweating	they aren't sweating
he ain't tooting	he isn't tooting
she ain't tooting	she isn't tooting
they ain't tooting	they aren't tooting
he ain't wishing	he isn't wishing
she ain't wishing	she isn't wishing
they ain't wishing	they aren't wishing
he ain't joking	he isn't joking
she ain't joking	she isn't joking
they ain't joking	they aren't joking
he ain't pushing	he isn't pushing
she ain't pushing	she isn't pushing
they ain't pushing	they aren't pushing
he ain't saving	he isn't saving
she ain't saving	she isn't saving
they ain't saving	they aren't saving
he ain't stopping	he isn't stopping
she ain't stopping	she isn't stopping
they ain't stopping	they aren't stopping
he ain't slamming	he isn't slamming
she ain't slamming	she isn't slamming
they ain't slamming	they aren't slamming
he ain't minging	he isn't minging
she ain't minging	she isn't minging
they ain't minging	they aren't minging
he ain't shagging	he isn't shagging
she ain't shagging	she isn't shagging
they ain't shagging	they aren't shagging
he ain't changing	he isn't changing
she ain't changing	she isn't changing
they ain't changing	they aren't changing
he ain't cooling	he isn't cooling
she ain't cooling	she isn't cooling
they ain't cooling	they aren't cooling
he ain't trucking	he isn't trucking
she ain't trucking	she isn't trucking
they ain't trucking	they aren't trucking
he ain't reading	he isn't reading
she ain't reading	she isn't reading
they ain't reading	they aren't reading
he ain't fukking	he isn't fukking
she ain't fukking	she isn't fukking
they ain't fukking	they aren't fukking
he ain't buying	he isn't buying
she ain't buying	she isn't buying
they ain't buying	they aren't buying
he ain't shopping	he isn't shopping
she ain't shopping	she isn't shopping
they ain't shopping	they aren't shopping
he ain't forking	he isn't forking
she ain't forking	she isn't forking
they ain't forking	they aren't forking
he ain't boring	he isn't boring
she ain't boring	she isn't boring
they ain't boring	they aren't boring
he ain't hurting	he isn't hurting
she ain't hurting	she isn't hurting
they ain't hurting	they aren't hurting
he ain't painting	he isn't painting
she ain't painting	she isn't painting
they ain't painting	they aren't painting
he ain't anything	he isn't anything
she ain't anything	she isn't anything
they ain't anything	they aren't anything
he ain't beefing	he isn't beefing
she ain't beefing	she isn't beefing
they ain't beefing	they aren't beefing
he ain't meeting	he isn't meeting
she ain't meeting	she isn't meeting
they ain't meeting	they aren't meeting
he ain't bumping	he isn't bumping
she ain't bumping	she isn't bumping
they ain't bumping	they aren't bumping
he ain't frikking	he isn't frikking
she ain't frikking	she isn't frikking
they ain't frikking	they aren't frikking
he ain't smashing	he isn't smashing
she ain't smashing	she isn't smashing
they ain't smashing	they aren't smashing
he ain't spanking	he isn't spanking
she ain't spanking	she isn't spanking
they ain't spanking	they aren't spanking
he ain't werking	he isn't werking
she ain't werking	she isn't werking
they ain't werking	they aren't werking
he ain't stunning	he isn't stunning
she ain't stunning	she isn't stunning
they ain't stunning	they aren't stunning
he ain't losing	he isn't losing
she ain't losing	she isn't losing
they ain't losing	they aren't losing
he ain't sucking	he isn't sucking
she ain't sucking	she isn't sucking
they ain't sucking	they aren't sucking
he ain't letting	he isn't letting
she ain't letting	she isn't letting
they ain't letting	they aren't letting
he ain't twerking	he isn't twerking
she ain't twerking	she isn't twerking
they ain't twerking	they aren't twerking
he ain't shooting	he isn't shooting
she ain't shooting	she isn't shooting
they ain't shooting	they aren't shooting